..........
..@@@@@@..
.########.
..######..
..######..
..######..
..######..