..........
..$$$$$$..
..$$$$$$..
.$##$$##$.
..$$$$$$..
..$$$$$$..