..........
..$$$$$$..
.########.
..######..
..######..
..######..
..######..